11111111
10000011
100P1C11
1E000011
11111111
