111111111111111111111111111111111111
1000P00E0C01100000000001100000000001
100000000001100000000001100000000001
100000000001100000000001100000000001
100000000001100000000001100000000001
100000000001100000000001100000000001
100000000001100000000001100000000001
100000000001100000000001100000000001
100000000001100000000001100000000001
100000000001100000000001100000000001
111111111111111111111111111111111111
