111111111111
1000P00E0C01
100000000001
111111111111
